20
0 0  
23 187  
345 45  
99 300 2 3 4 5 6 7 8 9 10 11 12 13 14 15 16 
211 400  
150 230 2 3 4 5 6 7 8 9 10 11 12 13 14 15 16 
275 390  
88 60 2 3 4 5 6 7 8 9 10 11 12 13 14 15 16 
400 320  
360 260 2 3 4 5 6 7 8 9 10 11 12 13 14 15 16 
75 125  
210 310 2 3 4 5 6 7 8 9 10 11 12 13 14 15 16 
455 100  
305 275 2 3 4 5 6 7 8 9 10 11 12 13 14 15 16 
180 480  
50 375 2 3 4 5 6 7 8 9 10 11 12 13 14 15 16 
420 220  
135 175 2 3 4 5 6 7 8 9 10 11 12 13 14 15 16 
250 50  
390 10 2 3 4 5 6 7 8 9 10 11 12 13 14 15 16 
60 290 2 3 4 5 6 7 8 9 10 11 12 13 14 15 16 
310 415  
145 370 2 3 4 5 6 7 8 9 10 11 12 13 14 15 16
270 90  
190 340 2 3 4 5 6 7 8 9 10 11 12 13 14 15 16 
380 140  
470 290 2 3 4 5 6 7 8 9 10 11 12 13 14 15 16 
220 180  
340 60 2 3 4 5 6 7 8 9 10 11 12 13 14 15 16 
410 410  
499 499