4
0 0
55 10 
22 110
79 140 2 3 4 5 6 7 
210 107 2 3 4 5 6 7 
34 281 2 3 4 5 6 7 
12 14 2 3 4 5 6 7 
90 90 
140 140 2 3 4 5 6 7
2 299
250 250
299 299